000000000000000000000000000000000000000000000000000000000000000000
00C0000C00000000C00000C0000000MTM000000C00000000000000C00000000000
0000C00000C000000000C000000000BBB0000000000000C00000000000000000X0
00000000000000C0000000000C0000000000000000000000000000000C00MM0BBB
0000000C0000000000000000000000000000C000000C0000000000000000000000
000C000000000000000C000000000000000000000000000000C000000000000000
0000000000000000000000000000000000000000000000000000000000MMUU0000
000000C00000000000000000000000000000000000000000000000000M00M00000
00C000000C00000000000000000MMV00000000000000000000000000MB00BM0000
00000000000000000000000000BBB00000000000000000000000000MBB00BBM000
00000000MM0MMMMM0000000M0BMMM0050000000000000000000000MBB0000BBM00
0000000000HHH00000400M0BGGGGGGGGGG000000000000000000MBBB00VV00BBM0
0000000000000000BBBBBB0MEEEEEEEEEE000000MMMMMM0000MBBB000MBBM0BBB6
0000000000000000BB1MMM0BEEEEEEEEEEGGGGG0RRR00000MBBB0M0MMBBBBM0BBB
0000000000000000BBBBBB0MEEEEEEEEEEEEEEE00000000MBBBB000BBB2BBB0MBB
000000MM000000000M00000BEEEEEEEEEEEEEEE0000000MBBBBB000BBB0BBM0BBB
0000MMBBVV000000000GGGGGEEEEEEEEEEBBBBB0000000BBBBBMMUMBBM0MBB0MBB
00BBBBB000000000000EEEEEEEEEBBBBBBB000000MMM0000AMMMBBBBMMUMMM0BBB
PBBMMM000AMMMMMM0U0EEEEBBBBBB0000000BBB0HH000UBBBBBBBTMMMBBBBB00BB
GGGGGGGGGGHHH000GGGEEEEB300S00BBBBBBBEE0000000GGGGGGGGGGGGGGG000GG
EEEEEEEEEEWWWWWWEEEEEEEBBBBBBBEEEEEEEEELLLLLLLEEEEEEEEEEEEEEELLLEE